91151553953913B9515115151151511515391517
AEA941506942EC46D296C1416C1416A92BC2A907
C3AAFC543E96BFFFD2A91416BFEFED4684140283
96C07FFFC1412FFFFA86EFC52FFFFFFFEFA96AAA
8512FFFFD456C7FFD443BD3907FFFFBBB944102E
C16C7FFFFFFFFFFFFFFC2906C3BBBF844013AA83
9417FBBFFFFFFFFFFFB942A9142C2D2912AA86AA
83ABBAAFFFFFFFFFFF8416C281412D2AA80403EA
AC2842ABFFFFFFFFFD41413868168382AA83AC16
A9447C42BBBFFFFFFFD016C2BAC3A86AAAAC2943
AC17FF94442FFFFFFFD2C13804504012AA812C3E
C16FFF851387FFFFFFD412AA8792BAA82C2A8143
FEFFFD296C6FFFFFFFFFAAA8016A844283C2AC3A
FFFFFD2857FFFFFFFFFD282AA83C29142C52852A
FFFFFD4457FFFFFFFFFD428442C386C103D28142
FFFFFFFFFFFFFFFFFFFFFC2950504396A852AA92
FFFFFFFFFFFFFFFFFFFFFFC294387C69681686AA
FFFFFFFFFFFFFFFFFFFFFFFC296815383A83812A
FFFFFFFFFFFFFFFFFFFFFFFD281683C2842C6EAA
FFFFFFFFFFFFFFFFFFFFFFFD42A968500385152A
FFFFFFFFFFFFFFFFFFFFFFFFB8029412A8414142
FFFFFFFFFFFFFFFFFFFFFFFB86AAA968283A9292
FFFFFFFFFFFFFFFFFFFFFBB84542AC12C2846AAA
FFFFFFFFFFFFFFFBBBBFF844111443A852E916AA
FFFFFFFFFFFFFFF8442FD2912AC13C401416812A
FFFFFFFFFFFFFFD417ABD42A8412851285016AAA
FFFFFFFFFFFFFFFFAFC2B96A83AAA96EAD2812AA
FFFFFFFFFFFFFFFD2F90441428284415416AA86A
FFFFFFFFFFFFFFFD2FAC3D292A841385387AA852
FFFFFFFFFFFFFFFD29294382A82BA843803A8412
FFFFFFFFFFFFFFF96AEC14282AAA84102AA8416A
FFFFFFFFFFFFFFFA929529428402ABAAA8043A96
FFFFFFFFFFFFFF902AC3C2D28528282846C3A843
FFFFFFFFFFFFFFAE84547A968382828451542816
FFFFFFFFFFFFBB8541517843AAA8280116912A83
FFFFFFFFFFFF82C3FEFAFC10442AAAAA852AC2AA
FFFFFFFFFFFD283C3FD2BBAC13A828428168502A
FFFFFFFFFFB92AAD2FD444012A868416AABA92AA
FFFFFFFFFFC2A86B87D3912AAE83814144286AAA
FFFFFFFFFD5444546FD46EC6C56C6C54554456C6

1,1
36,39
NEEEEEESENEESENEESEENEEEEESESESEESSESESEESESSEESESSSESSESSSSWSSSSESESESSSSESSSSSSSSSW
